4 4 4 4 4 4 4 4 4 4 4 4 4 4 4 4
1 1 1 1 1 1 1 1 1 1 1 1 1 1 1 1
1 3 3 3 3 3 3 3 3 3 3 3 3 3 3 1
1 3 3 1 3 3 3 3 3 3 3 3 1 3 3 1
1 1 1 1 3 3 1 3 3 1 3 3 1 1 1 1
1 3 3 3 3 1 3 3 3 3 1 3 3 3 3 1
1 3 3 3 3 1 3 3 3 3 1 3 3 3 3 1
1 3 3 3 3 1 3 3 3 3 1 3 3 3 3 1
1 1 1 1 3 3 1 6 3 1 3 3 1 1 1 1
1 3 3 1 3 3 3 3 3 3 3 3 1 3 3 1
1 3 3 3 3 3 3 3 3 3 3 3 3 3 3 1 
1 1 1 1 1 1 1 1 1 1 1 1 1 1 1 1
