1 0 0 0 0 0 0 0 0 0 0 0 0 0 0 0 0 0 0 0 0 0 0 2
4 3 3 3 3 3 3 3 3 4 3 3 3 3 4 3 3 3 3 3 3 3 3 4
4 3 3 3 3 3 3 3 3 4 3 3 3 3 4 3 3 3 3 3 3 3 3 4
4 3 3 3 3 3 3 3 3 4 3 3 3 3 4 3 3 3 3 3 3 3 3 4
4 3 3 3 3 3 3 3 3 3 3 3 3 3 3 3 3 3 3 3 3 3 3 4
4 3 3 3 3 3 3 3 3 3 3 3 3 3 3 3 3 3 3 3 3 3 3 4
4 4 4 4 3 3 3 3 3 3 3 3 3 3 3 3 3 3 3 3 4 4 4 4
7 7 7 4 3 3 7 7 3 3 4 3 3 4 3 3 7 7 3 3 4 7 7 7
7 7 7 4 3 3 7 3 3 3 4 3 3 4 3 3 3 7 3 3 4 7 7 7
4 4 4 4 3 3 3 3 3 3 4 4 4 4 3 3 3 3 3 3 4 4 4 4
4 3 3 3 3 3 3 3 3 3 3 3 3 3 3 3 3 3 3 3 3 3 3 4
4 3 3 3 3 4 3 3 4 4 4 4 4 3 3 4 3 3 3 3 3 3 3 4
4 3 3 3 3 4 3 3 3 3 4 3 3 3 3 4 3 3 3 3 3 3 3 4
4 3 4 4 4 4 3 3 3 3 4 3 3 3 3 4 4 4 4 3 3 3 3 4
4 3 3 3 3 3 3 3 3 3 3 3 3 3 3 3 3 3 3 3 3 3 3 4
4 4 4 4 4 4 4 4 4 4 4 4 4 4 4 4 4 4 4 4 4 4 4 4